11101111
10000P01
10000001
10C00001
10000E01
11111111
