11111111
10000P01
10000001
10C00001
100000E1
111111111
