11111111
10000P01
10000001
10C00001
1000EE01
11110111
