11111111
10000P01
10000001
10C00000
10000E01
11111111
