11111111111
11110C01111
11110001111
11110001111
111100K1111
10000000001
1C0K0P010E1
10000000001
1111K0K1111
11110001111
11110E01111
11111111111
